7 7
[34 186 53] [20 20 20] [240 146 84] [240 215 178]
0 1 1 1 1 1 0
0 1 1 1 1 1 0
0 2 2 2 2 2 0
1 1 1 1 1 1 1
0 3 4 4 4 3 0
0 3 4 4 4 3 0
0 0 3 3 3 0 0