6 6
[32 175 25] [69 39 0]
0 0 1 1 0 0
0 1 1 1 1 0
0 1 1 1 1 0
0 1 1 1 1 0
0 0 2 2 0 0
0 0 2 2 0 0