5 5
[0 200 0] [0 0 200]
1 1 1 1 1
0 0 0 0 0
2 2 2 2 2
0 0 0 0 0
1 1 1 1 1