5 5
[240 215 52] [8 156 8]
2 0 0 0 0
0 0 1 0 1
1 0 1 1 1
1 1 1 0 0
0 0 1 0 0