5 5
[86 236 30] [30 124 236]
1 0 0 0 1
2 1 0 1 2
2 1 1 0 2
1 2 2 0 0
0 0 1 0 0