5 5
[198 61 23] [198 160 23]
0 1 1 1 0
1 1 2 1 1
1 2 1 2 1
1 1 2 1 1
0 1 1 1 0