5 5
[39 236 48] [93 104 221]
1 0 0 0 1
0 0 2 0 1
1 2 1 1 1
1 0 2 0 0
0 0 0 0 0